~~~~~~~~~~~~~~~~~~~~
~..................~
~..................~
~...X..GGGGG.......~
~..~~~.GGGGG.......~
~......GG~GG.......~
~......GGGGG.......~
~......GGGGG.......~
~......GGGGG~......~
~............~.....~
~.............~....~
~..............~...~
~......G.G.G.....D.~
~.1................~
~~~~~~~~~~~~~~~~~~~~