....................
................G...
..........X....GG...
.......~~~~~~..G....
A.G............G....
~~~~..G.G.G.G..GG~~~
.......G.G.GCG..G...
......--------..GGG.
...---------------GG
.............GGGG.GG
BG.G.........G..GGG.
~~~~....---.....~~~~
....................
.1..................
####################
